TEXTURES
1
RoadTileSheet.png|64|64
DRAW_SIZE
832|832
TILE_SIZE
64|64
MAP_SIZE
140|13
SCROLL_ENABLE
HV
SCROLL_LOOP_MODE
V
START_TILE
0|0
HOLE_COLOR
FF8000FF
EVENT_NAMES
StartBeepJump|StopBeepJump|PosEndRaceGrid|StartBigTreeArea|EndBigTreeArea|StartStrawArea|EndStrawArea|StartOilArea|EndOilArea|FogON|FogOFF
GROUND_NAMES
Hole|Neutral|Road|Grass|Water|Railway
FRAMES_TYPE
1
8|8|3|2|2|3|2|2|2|2|2|2|2|2|2|2|2|3|2|2|4|4|4|3|3|3|3|3|3|3|2|3|3|3|2|2|2|2|2|3|3|3|2|2|2|2|2|1|5|5|1|1|1|1|1|1|1|1|1|1|1|1|1|1|1|1
DATA
T0,0,0,-1 T0,1,0,-1 T0,1,0,-1 T0,2,0,-1 T0,1,0,-1 T0,1,0,-1 T0,2,0,-1 T0,1,0,-1 T0,1,0,-1 T0,2,0,-1 T0,1,0,-1 T0,1,0,-1 T0,3,0,-1
T0,0,0,-1 T0,1,0,-1 T0,1,0,-1 T0,2,0,-1 T0,1,0,-1 T0,1,0,-1 T0,2,0,-1 T0,1,0,-1 T0,1,0,-1 T0,2,0,-1 T0,1,0,-1 T0,1,0,-1 T0,3,0,-1
T0,0,0,-1 T0,1,0,-1 T0,1,0,-1 T0,2,0,-1 T0,1,0,-1 T0,1,0,-1 T0,2,0,-1 T0,1,0,-1 T0,1,0,-1 T0,2,0,-1 T0,1,0,-1 T0,1,0,-1 T0,3,0,-1
T0,0,0,-1 T0,1,0,-1 T0,1,0,-1 T0,2,0,-1 T0,1,0,-1 T0,1,0,-1 T0,2,0,-1 T0,1,0,-1 T0,1,0,-1 T0,2,0,-1 T0,1,0,-1 T0,1,0,-1 T0,3,0,-1
T0,0,0,-1 T0,1,0,-1 T0,1,0,-1 T0,2,0,-1 T0,1,0,-1 T0,1,0,-1 T0,2,0,-1 T0,1,0,-1 T0,1,0,-1 T0,2,0,-1 T0,1,0,-1 T0,1,0,-1 T0,3,0,-1
T0,0,0,-1 T0,1,0,-1 T0,1,0,-1 T0,2,0,-1 T0,1,0,-1 T0,1,0,-1 T0,2,0,-1 T0,1,0,-1 T0,1,0,-1 T0,2,0,-1 T0,1,0,-1 T0,1,0,-1 T0,3,0,-1
T0,0,0,-1 T0,1,0,-1 T0,1,0,-1 T0,2,0,-1 T0,1,0,-1 T0,1,0,-1 T0,2,0,-1 T0,1,0,-1 T0,1,0,-1 T0,2,0,-1 T0,1,0,-1 T0,1,0,-1 T0,3,0,-1
T0,0,0,-1 T0,1,0,-1 T0,1,0,-1 T0,2,0,-1 T0,1,0,-1 T0,1,0,-1 T0,2,0,-1 T0,1,0,-1 T0,1,0,-1 T0,2,0,-1 T0,1,0,-1 T0,1,0,-1 T0,3,0,-1
T0,0,0,-1 T0,1,0,-1 T0,1,0,-1 T0,2,0,-1 T0,1,0,-1 T0,1,0,-1 T0,2,0,-1 T0,1,0,-1 T0,1,0,-1 T0,2,0,-1 T0,1,0,-1 T0,1,0,-1 T0,3,0,-1
T0,0,0,-1 T0,1,0,-1 T0,1,0,-1 T0,2,0,-1 T0,1,0,-1 T0,1,0,-1 T0,2,0,-1 T0,1,0,-1 T0,1,0,-1 T0,2,0,-1 T0,1,0,-1 T0,1,0,-1 T0,3,0,-1
T0,0,0,-1 T0,1,0,-1 T0,1,0,-1 T0,2,0,-1 T0,1,0,-1 T0,1,0,-1 T0,2,0,-1 T0,1,0,-1 T0,1,0,-1 T0,2,0,-1 T0,1,0,-1 T0,1,0,-1 T0,3,0,-1
T0,0,0,-1 T0,1,0,-1 T0,1,0,-1 T0,2,0,-1 T0,1,0,-1 T0,1,0,-1 T0,2,0,-1 T0,1,0,-1 T0,1,0,-1 T0,2,0,-1 T0,1,0,-1 T0,1,0,-1 T0,3,0,-1
T0,0,0,-1 T0,1,0,-1 T0,1,0,-1 T0,2,0,-1 T0,1,0,-1 T0,1,0,-1 T0,2,0,-1 T0,1,0,-1 T0,1,0,-1 T0,2,0,-1 T0,1,0,-1 T0,1,0,-1 T0,3,0,-1
T0,0,0,-1 T0,1,0,-1 T0,1,0,-1 T0,2,0,-1 T0,1,0,-1 T0,1,0,-1 T0,2,0,-1 T0,1,0,-1 T0,1,0,-1 T0,2,0,-1 T0,1,0,-1 T0,1,0,-1 T0,3,0,-1
T0,0,0,-1 T0,1,0,-1 T0,1,0,-1 T0,2,0,-1 T0,1,0,-1 T0,1,0,-1 T0,2,0,-1 T0,1,0,-1 T0,1,0,-1 T0,2,0,-1 T0,1,0,-1 T0,1,0,-1 T0,3,0,-1
T0,0,0,-1 T0,1,0,-1 T0,1,0,-1 T0,2,0,-1 T0,1,0,-1 T0,1,0,-1 T0,2,0,-1 T0,1,0,-1 T0,1,0,-1 T0,2,0,-1 T0,1,0,-1 T0,1,0,-1 T0,3,0,-1
T0,0,0,-1 T0,1,0,-1 T0,1,0,-1 T0,2,0,-1 T0,1,0,-1 T0,1,0,-1 T0,2,0,-1 T0,1,0,-1 T0,1,0,-1 T0,2,0,-1 T0,1,0,-1 T0,1,0,-1 T0,3,0,-1
T0,0,0,-1 T0,1,0,-1 T0,1,0,-1 T0,2,0,-1 T0,1,0,-1 T0,1,0,-1 T0,2,0,-1 T0,1,0,-1 T0,1,0,-1 T0,2,0,-1 T0,1,0,-1 T0,1,0,-1 T0,3,0,-1
T0,0,0,-1 T0,1,0,-1 T0,1,0,-1 T0,2,0,-1 T0,1,0,-1 T0,1,0,-1 T0,2,0,-1 T0,1,0,-1 T0,1,0,-1 T0,2,0,-1 T0,1,0,-1 T0,1,0,-1 T0,3,0,-1
T0,0,0,-1 T0,1,0,-1 T0,1,0,-1 T0,2,0,-1 T0,1,0,-1 T0,1,0,-1 T0,2,0,-1 T0,1,0,-1 T0,1,0,-1 T0,2,0,-1 T0,1,0,-1 T0,1,0,-1 T0,3,0,-1
T0,0,0,-1 T0,1,0,-1 T0,1,0,-1 T0,2,0,-1 T0,1,0,-1 T0,1,0,-1 T0,2,0,-1 T0,1,0,-1 T0,1,0,-1 T0,2,0,-1 T0,1,0,-1 T0,1,0,-1 T0,3,0,-1
T0,0,0,-1 T0,1,0,-1 T0,1,0,-1 T0,2,0,-1 T0,1,0,-1 T0,1,0,-1 T0,2,0,-1 T0,1,0,-1 T0,1,0,-1 T0,2,0,-1 T0,1,0,-1 T0,1,0,-1 T0,3,0,-1
T0,0,0,-1 T0,1,0,-1 T0,1,0,-1 T0,2,0,-1 T0,1,0,-1 T0,1,0,-1 T0,2,0,-1 T0,1,0,-1 T0,1,0,-1 T0,2,0,-1 T0,1,0,-1 T0,1,0,-1 T0,3,0,-1
T0,0,0,-1 T0,1,0,-1 T0,1,0,-1 T0,2,0,-1 T0,1,0,-1 T0,1,0,-1 T0,2,0,-1 T0,1,0,-1 T0,1,0,-1 T0,2,0,-1 T0,1,0,-1 T0,1,0,-1 T0,3,0,-1
T0,0,0,-1 T0,1,0,-1 T0,1,0,-1 T0,2,0,-1 T0,1,0,-1 T0,1,0,-1 T0,2,0,-1 T0,1,0,-1 T0,1,0,-1 T0,2,0,-1 T0,1,0,-1 T0,1,0,-1 T0,3,0,-1
T0,0,0,-1 T0,1,0,-1 T0,1,0,-1 T0,2,0,-1 T0,1,0,-1 T0,1,0,-1 T0,2,0,-1 T0,1,0,-1 T0,1,0,-1 T0,2,0,-1 T0,1,0,-1 T0,1,0,-1 T0,3,0,-1
T0,0,0,-1 T0,1,0,-1 T0,1,0,-1 T0,2,0,-1 T0,1,0,-1 T0,1,0,-1 T0,2,0,-1 T0,1,0,-1 T0,1,0,-1 T0,2,0,-1 T0,1,0,-1 T0,1,0,-1 T0,3,0,-1
T0,0,0,-1 T0,1,0,-1 T0,1,0,-1 T0,2,0,-1 T0,1,0,-1 T0,1,0,-1 T0,2,0,-1 T0,1,0,-1 T0,1,0,-1 T0,2,0,-1 T0,1,0,-1 T0,1,0,-1 T0,3,0,-1
T0,0,0,-1 T0,1,0,-1 T0,1,0,-1 T0,2,0,-1 T0,1,0,-1 T0,1,0,-1 T0,2,0,-1 T0,1,0,-1 T0,1,0,-1 T0,2,0,-1 T0,1,0,-1 T0,1,0,-1 T0,3,0,-1
T0,0,0,-1 T0,1,0,-1 T0,1,0,-1 T0,2,0,-1 T0,1,0,-1 T0,1,0,-1 T0,2,0,-1 T0,1,0,-1 T0,1,0,-1 T0,2,0,-1 T0,1,0,-1 T0,1,0,-1 T0,3,0,-1
T0,0,0,-1 T0,1,0,-1 T0,1,0,-1 T0,2,0,-1 T0,1,0,-1 T0,1,0,-1 T0,2,0,-1 T0,1,0,-1 T0,1,0,-1 T0,2,0,-1 T0,1,0,-1 T0,1,0,-1 T0,3,0,-1
T0,0,0,-1 T0,1,0,-1 T0,1,0,-1 T0,2,0,-1 T0,1,0,-1 T0,1,0,-1 T0,2,0,-1 T0,1,0,-1 T0,1,0,-1 T0,2,0,-1 T0,1,0,-1 T0,1,0,-1 T0,3,0,-1
T0,0,0,-1 T0,1,0,-1 T0,1,0,-1 T0,2,0,-1 T0,1,0,-1 T0,1,0,-1 T0,2,0,-1 T0,1,0,-1 T0,1,0,-1 T0,2,0,-1 T0,1,0,-1 T0,1,0,-1 T0,3,0,-1
T0,0,0,-1 T0,1,0,-1 T0,1,0,-1 T0,2,0,-1 T0,1,0,-1 T0,1,0,-1 T0,2,0,-1 T0,1,0,-1 T0,1,0,-1 T0,2,0,-1 T0,1,0,-1 T0,1,0,-1 T0,3,0,-1
T0,0,0,-1 T0,1,0,-1 T0,1,0,-1 T0,2,0,-1 T0,1,0,-1 T0,1,0,-1 T0,2,0,-1 T0,1,0,-1 T0,1,0,-1 T0,2,0,-1 T0,1,0,-1 T0,1,0,-1 T0,3,0,-1
T0,0,0,-1 T0,1,0,-1 T0,1,0,-1 T0,2,0,-1 T0,1,0,-1 T0,1,0,-1 T0,2,0,-1 T0,1,0,-1 T0,1,0,-1 T0,2,0,-1 T0,1,0,-1 T0,1,0,-1 T0,3,0,-1
T0,0,0,-1 T0,1,0,-1 T0,1,0,-1 T0,2,0,-1 T0,1,0,-1 T0,1,0,-1 T0,2,0,-1 T0,1,0,-1 T0,1,0,-1 T0,2,0,-1 T0,1,0,-1 T0,1,0,-1 T0,3,0,-1
T0,0,0,-1 T0,1,0,-1 T0,1,0,-1 T0,2,0,-1 T0,1,0,-1 T0,1,0,-1 T0,2,0,-1 T0,1,0,-1 T0,1,0,-1 T0,2,0,-1 T0,1,0,-1 T0,1,0,-1 T0,3,0,-1
T0,0,0,-1 T0,1,0,-1 T0,1,0,-1 T0,2,0,-1 T0,1,0,-1 T0,1,0,-1 T0,2,0,-1 T0,1,0,-1 T0,1,0,-1 T0,2,0,-1 T0,1,0,-1 T0,1,0,-1 T0,3,0,-1
T0,0,0,-1 T0,1,0,-1 T0,1,0,-1 T0,2,0,-1 T0,1,0,-1 T0,1,0,-1 T0,2,0,-1 T0,1,0,-1 T0,1,0,-1 T0,2,0,-1 T0,1,0,-1 T0,1,0,-1 T0,3,0,-1
T0,0,0,-1 T0,1,0,-1 T0,1,0,-1 T0,2,0,-1 T0,1,0,-1 T0,1,0,-1 T0,2,0,-1 T0,1,0,-1 T0,1,0,-1 T0,2,0,-1 T0,1,0,-1 T0,1,0,-1 T0,3,0,-1
T0,0,0,-1 T0,1,0,-1 T0,1,0,-1 T0,2,0,-1 T0,1,0,-1 T0,1,0,-1 T0,2,0,-1 T0,1,0,-1 T0,1,0,-1 T0,2,0,-1 T0,1,0,-1 T0,1,0,-1 T0,3,0,-1
T0,0,0,-1 T0,1,0,-1 T0,1,0,-1 T0,2,0,-1 T0,1,0,-1 T0,1,0,-1 T0,2,0,-1 T0,1,0,-1 T0,1,0,-1 T0,2,0,-1 T0,1,0,-1 T0,1,0,-1 T0,3,0,-1
T0,0,0,-1 T0,1,0,-1 T0,1,0,-1 T0,2,0,-1 T0,1,0,-1 T0,1,0,-1 T0,2,0,-1 T0,1,0,-1 T0,1,0,-1 T0,2,0,-1 T0,1,0,-1 T0,1,0,-1 T0,3,0,-1
T0,0,0,-1 T0,1,0,-1 T0,1,0,-1 T0,2,0,-1 T0,1,0,-1 T0,1,0,-1 T0,2,0,-1 T0,1,0,-1 T0,1,0,-1 T0,2,0,-1 T0,1,0,-1 T0,1,0,-1 T0,3,0,-1
T0,0,0,-1 T0,1,0,-1 T0,1,0,-1 T0,2,0,-1 T0,1,0,-1 T0,1,0,-1 T0,2,0,-1 T0,1,0,-1 T0,1,0,-1 T0,2,0,-1 T0,1,0,-1 T0,1,0,-1 T0,3,0,-1
T0,0,0,-1 T0,1,0,-1 T0,1,0,-1 T0,2,0,-1 T0,1,0,-1 T0,1,0,-1 T0,2,0,-1 T0,1,0,-1 T0,1,0,-1 T0,2,0,-1 T0,1,0,-1 T0,1,0,-1 T0,3,0,-1
T0,0,0,-1 T0,1,0,-1 T0,1,0,-1 T0,2,0,-1 T0,1,0,-1 T0,1,0,-1 T0,2,0,-1 T0,1,0,-1 T0,1,0,-1 T0,2,0,-1 T0,1,0,-1 T0,1,0,-1 T0,3,0,-1
T0,0,0,-1 T0,1,0,-1 T0,1,0,-1 T0,2,0,-1 T0,1,0,-1 T0,1,0,-1 T0,2,0,-1 T0,1,0,-1 T0,1,0,-1 T0,2,0,-1 T0,1,0,-1 T0,1,0,-1 T0,3,0,-1
T0,0,0,-1 T0,1,0,-1 T0,1,0,-1 T0,2,0,-1 T0,1,0,-1 T0,1,0,-1 T0,2,0,-1 T0,1,0,-1 T0,1,0,-1 T0,2,0,-1 T0,1,0,-1 T0,1,0,-1 T0,3,0,-1
T0,0,0,-1 T0,1,0,-1 T0,1,0,-1 T0,2,0,-1 T0,1,0,-1 T0,1,0,-1 T0,2,0,-1 T0,1,0,-1 T0,1,0,-1 T0,2,0,-1 T0,1,0,-1 T0,1,0,-1 T0,3,0,-1
T0,0,0,-1 T0,1,0,-1 T0,1,0,-1 T0,2,0,-1 T0,1,0,-1 T0,1,0,-1 T0,2,0,-1 T0,1,0,-1 T0,1,0,-1 T0,2,0,-1 T0,1,0,-1 T0,1,0,-1 T0,3,0,-1
T0,0,0,-1 T0,1,0,-1 T0,1,0,-1 T0,2,0,-1 T0,1,0,-1 T0,1,0,-1 T0,2,0,-1 T0,1,0,-1 T0,1,0,-1 T0,2,0,-1 T0,1,0,-1 T0,1,0,-1 T0,3,0,-1
T0,0,0,-1 T0,1,0,-1 T0,1,0,-1 T0,2,0,-1 T0,1,0,-1 T0,1,0,-1 T0,2,0,-1 T0,1,0,-1 T0,1,0,-1 T0,2,0,-1 T0,1,0,-1 T0,1,0,-1 T0,3,0,-1
T0,0,0,-1 T0,1,0,-1 T0,1,0,-1 T0,2,0,-1 T0,1,0,-1 T0,1,0,-1 T0,2,0,-1 T0,1,0,-1 T0,1,0,-1 T0,2,0,-1 T0,1,0,-1 T0,1,0,-1 T0,3,0,-1
T0,0,0,-1 T0,4,1,-1 T0,4,1,-1 T0,4,1,-1 T0,1,0,-1 T0,1,0,-1 T0,2,0,-1 T0,1,0,-1 T0,1,0,-1 T0,4,1,-1 T0,4,1,-1 T0,4,1,-1 T0,3,0,-1
T0,2,2,-1 T0,2,2,-1 T0,2,2,-1 T0,2,2,-1 T0,4,0,-1 T0,1,0,-1 T0,2,0,-1 T0,1,0,-1 T0,0,1,-1 T0,3,2,-1 T0,2,2,-1 T0,2,2,-1 T0,2,2,-1
T0,2,2,-1 T0,2,2,-1 T0,2,2,-1 T0,2,2,-1 T0,4,0,-1 T0,1,0,-1 T0,2,0,-1 T0,1,0,-1 T0,0,1,-1 T0,3,2,-1 T0,2,2,-1 T0,2,2,-1 T0,2,2,-1
T0,2,2,-1 T0,2,2,-1 T0,2,2,-1 T0,2,2,-1 T0,4,0,-1 T0,1,0,-1 T0,2,0,-1 T0,1,0,-1 T0,0,1,-1 T0,3,2,-1 T0,2,2,-1 T0,2,2,-1 T0,2,2,-1
T0,2,2,-1 T0,2,2,-1 T0,2,2,-1 T0,2,2,-1 T0,4,0,-1 T0,1,0,-1 T0,2,0,-1 T0,1,0,-1 T0,0,1,-1 T0,3,2,-1 T0,2,2,-1 T0,2,2,-1 T0,2,2,-1
T0,2,2,-1 T0,2,2,-1 T0,2,2,-1 T0,2,2,-1 T0,4,0,-1 T0,1,0,-1 T0,2,0,-1 T0,1,0,-1 T0,0,1,-1 T0,3,2,-1 T0,2,2,-1 T0,2,2,-1 T0,2,2,-1
T0,2,2,-1 T0,2,2,-1 T0,2,2,-1 T0,2,2,-1 T0,4,0,-1 T0,1,0,-1 T0,2,0,-1 T0,1,0,-1 T0,0,1,-1 T0,3,2,-1 T0,2,2,-1 T0,2,2,-1 T0,2,2,-1
T0,2,2,-1 T0,2,2,-1 T0,2,2,-1 T0,2,2,-1 T0,4,0,-1 T0,1,0,-1 T0,2,0,-1 T0,1,0,-1 T0,0,1,-1 T0,3,2,-1 T0,2,2,-1 T0,2,2,-1 T0,2,2,-1
T0,2,2,-1 T0,2,2,-1 T0,2,2,-1 T0,2,2,-1 T0,4,0,-1 T0,1,0,-1 T0,2,0,-1 T0,1,0,-1 T0,0,1,-1 T0,3,2,-1 T0,2,2,-1 T0,2,2,-1 T0,2,2,-1
T0,2,2,-1 T0,2,2,-1 T0,2,2,-1 T0,2,2,-1 T0,4,0,-1 T0,1,0,-1 T0,2,0,-1 T0,1,0,-1 T0,0,1,-1 T0,3,2,-1 T0,2,2,-1 T0,2,2,-1 T0,2,2,-1
T0,2,2,-1 T0,2,2,-1 T0,2,2,-1 T0,2,2,-1 T0,4,0,-1 T0,1,0,-1 T0,2,0,-1 T0,1,0,-1 T0,0,1,-1 T0,3,2,-1 T0,2,2,-1 T0,2,2,-1 T0,2,2,-1
T0,2,2,-1 T0,2,2,-1 T0,2,2,-1 T0,2,2,-1 T0,4,0,-1 T0,1,0,-1 T0,2,0,-1 T0,1,0,-1 T0,0,1,-1 T0,3,2,-1 T0,2,2,-1 T0,2,2,-1 T0,2,2,-1
T0,2,2,-1 T0,2,2,-1 T0,2,2,-1 T0,2,2,-1 T0,4,0,-1 T0,1,0,-1 T0,2,0,-1 T0,1,0,-1 T0,0,1,-1 T0,3,2,-1 T0,2,2,-1 T0,2,2,-1 T0,2,2,-1
T0,2,2,-1 T0,2,2,-1 T0,2,2,-1 T0,2,2,-1 T0,4,0,-1 T0,1,0,-1 T0,2,0,-1 T0,1,0,-1 T0,0,1,-1 T0,3,2,-1 T0,2,2,-1 T0,2,2,-1 T0,2,2,-1
T0,2,2,-1 T0,2,2,-1 T0,2,2,-1 T0,2,2,-1 T0,4,0,-1 T0,1,0,-1 T0,2,0,-1 T0,1,0,-1 T0,0,1,-1 T0,3,2,-1 T0,2,2,-1 T0,2,2,-1 T0,2,2,-1
T0,2,2,-1 T0,2,2,-1 T0,2,2,-1 T0,2,2,-1 T0,4,0,-1 T0,1,0,-1 T0,2,0,-1 T0,1,0,-1 T0,0,1,-1 T0,3,2,-1 T0,2,2,-1 T0,2,2,-1 T0,2,2,-1
T0,2,2,-1 T0,2,2,-1 T0,2,2,-1 T0,2,2,-1 T0,4,0,-1 T0,1,0,-1 T0,2,0,-1 T0,1,0,-1 T0,0,1,-1 T0,3,2,-1 T0,2,2,-1 T0,2,2,-1 T0,2,2,-1
T0,2,2,-1 T0,2,2,-1 T0,2,2,-1 T0,2,2,-1 T0,4,0,-1 T0,1,0,-1 T0,2,0,-1 T0,1,0,-1 T0,0,1,-1 T0,3,2,-1 T0,2,2,-1 T0,2,2,-1 T0,2,2,-1
T0,2,2,-1 T0,2,2,-1 T0,2,2,-1 T0,2,2,-1 T0,4,0,-1 T0,1,0,-1 T0,2,0,-1 T0,1,0,-1 T0,0,1,-1 T0,3,2,-1 T0,2,2,-1 T0,2,2,-1 T0,2,2,-1
T0,2,2,-1 T0,2,2,-1 T0,2,2,-1 T0,2,2,-1 T0,4,0,-1 T0,1,0,-1 T0,2,0,-1 T0,1,0,-1 T0,0,1,-1 T0,3,2,-1 T0,2,2,-1 T0,2,2,-1 T0,2,2,-1
T0,2,2,-1 T0,2,2,-1 T0,2,2,-1 T0,2,2,-1 T0,4,0,-1 T0,1,0,-1 T0,2,0,-1 T0,1,0,-1 T0,0,1,-1 T0,3,2,-1 T0,2,2,-1 T0,2,2,-1 T0,2,2,-1
T0,2,2,-1 T0,2,2,-1 T0,2,2,-1 T0,2,2,-1 T0,4,0,-1 T0,1,0,-1 T0,2,0,-1 T0,1,0,-1 T0,0,1,-1 T0,3,2,-1 T0,2,2,-1 T0,2,2,-1 T0,2,2,-1
T0,2,2,-1 T0,2,2,-1 T0,2,2,-1 T0,2,2,-1 T0,4,0,-1 T0,1,0,-1 T0,2,0,-1 T0,1,0,-1 T0,0,1,-1 T0,3,2,-1 T0,2,2,-1 T0,2,2,-1 T0,2,2,-1
T0,2,2,-1 T0,2,2,-1 T0,2,2,-1 T0,2,2,-1 T0,4,0,-1 T0,1,0,-1 T0,2,0,-1 T0,1,0,-1 T0,0,1,-1 T0,3,2,-1 T0,2,2,-1 T0,2,2,-1 T0,2,2,-1
T0,2,2,-1 T0,2,2,-1 T0,2,2,-1 T0,2,2,-1 T0,4,0,-1 T0,1,0,-1 T0,2,0,-1 T0,1,0,-1 T0,0,1,-1 T0,3,2,-1 T0,2,2,-1 T0,2,2,-1 T0,2,2,-1
T0,2,2,-1 T0,2,2,-1 T0,2,2,-1 T0,2,2,-1 T0,4,0,-1 T0,1,0,-1 T0,2,0,-1 T0,1,0,-1 T0,0,1,-1 T0,3,2,-1 T0,2,2,-1 T0,2,2,-1 T0,2,2,-1
T0,2,2,-1 T0,2,2,-1 T0,2,2,-1 T0,2,2,-1 T0,4,0,-1 T0,1,0,-1 T0,2,0,-1 T0,1,0,-1 T0,0,1,-1 T0,3,2,-1 T0,2,2,-1 T0,2,2,-1 T0,2,2,-1
T0,2,2,-1 T0,2,2,-1 T0,2,2,-1 T0,2,2,-1 T0,4,0,-1 T0,1,0,-1 T0,2,0,-1 T0,1,0,-1 T0,0,1,-1 T0,3,2,-1 T0,2,2,-1 T0,2,2,-1 T0,2,2,-1
T0,2,2,-1 T0,2,2,-1 T0,2,2,-1 T0,2,2,-1 T0,4,0,-1 T0,1,0,-1 T0,2,0,-1 T0,1,0,-1 T0,0,1,-1 T0,3,2,-1 T0,2,2,-1 T0,2,2,-1 T0,2,2,-1
T0,2,2,-1 T0,2,2,-1 T0,2,2,-1 T0,2,2,-1 T0,4,0,-1 T0,1,0,-1 T0,2,0,-1 T0,1,0,-1 T0,0,1,-1 T0,3,2,-1 T0,2,2,-1 T0,2,2,-1 T0,2,2,-1
T0,2,2,-1 T0,2,2,-1 T0,2,2,-1 T0,2,2,-1 T0,4,0,-1 T0,1,0,-1 T0,2,0,-1 T0,1,0,-1 T0,0,1,-1 T0,3,2,-1 T0,2,2,-1 T0,2,2,-1 T0,2,2,-1
T0,2,2,-1 T0,2,2,-1 T0,2,2,-1 T0,2,2,-1 T0,4,0,-1 T0,1,0,-1 T0,2,0,-1 T0,1,0,-1 T0,0,1,-1 T0,3,2,-1 T0,2,2,-1 T0,2,2,-1 T0,2,2,-1
T0,2,2,-1 T0,2,2,-1 T0,2,2,-1 T0,2,2,-1 T0,4,0,-1 T0,1,0,-1 T0,2,0,-1 T0,1,0,-1 T0,0,1,-1 T0,3,2,-1 T0,2,2,-1 T0,2,2,-1 T0,2,2,-1
T0,2,2,-1 T0,2,2,-1 T0,2,2,-1 T0,2,2,-1 T0,4,0,-1 T0,1,0,-1 T0,2,0,-1 T0,1,0,-1 T0,0,1,-1 T0,3,2,-1 T0,2,2,-1 T0,2,2,-1 T0,2,2,-1
T0,2,2,-1 T0,2,2,-1 T0,2,2,-1 T0,2,2,-1 T0,4,0,-1 T0,1,0,-1 T0,2,0,-1 T0,1,0,-1 T0,0,1,-1 T0,3,2,-1 T0,2,2,-1 T0,2,2,-1 T0,2,2,-1
T0,2,2,-1 T0,2,2,-1 T0,2,2,-1 T0,2,2,-1 T0,4,0,-1 T0,1,0,-1 T0,2,0,-1 T0,1,0,-1 T0,0,1,-1 T0,3,2,-1 T0,2,2,-1 T0,2,2,-1 T0,2,2,-1
T0,2,2,-1 T0,2,2,-1 T0,2,2,-1 T0,2,2,-1 T0,4,0,-1 T0,1,0,-1 T0,2,0,-1 T0,1,0,-1 T0,0,1,-1 T0,3,2,-1 T0,2,2,-1 T0,2,2,-1 T0,2,2,-1
T0,2,2,-1 T0,2,2,-1 T0,2,2,-1 T0,2,2,-1 T0,4,0,-1 T0,1,0,-1 T0,2,0,-1 T0,1,0,-1 T0,0,1,-1 T0,3,2,-1 T0,2,2,-1 T0,2,2,-1 T0,2,2,-1
T0,2,2,-1 T0,2,2,-1 T0,2,2,-1 T0,2,2,-1 T0,4,0,-1 T0,1,0,-1 T0,2,0,-1 T0,1,0,-1 T0,0,1,-1 T0,3,2,-1 T0,2,2,-1 T0,2,2,-1 T0,2,2,-1
T0,2,2,-1 T0,2,2,-1 T0,2,2,-1 T0,2,2,-1 T0,4,0,-1 T0,1,0,-1 T0,2,0,-1 T0,1,0,-1 T0,0,1,-1 T0,3,2,-1 T0,2,2,-1 T0,2,2,-1 T0,2,2,-1
T0,2,2,-1 T0,2,2,-1 T0,2,2,-1 T0,2,2,-1 T0,4,0,-1 T0,1,0,-1 T0,2,0,-1 T0,1,0,-1 T0,0,1,-1 T0,3,2,-1 T0,2,2,-1 T0,2,2,-1 T0,2,2,-1
T0,2,2,-1 T0,2,2,-1 T0,2,2,-1 T0,2,2,-1 T0,4,0,-1 T0,1,0,-1 T0,2,0,-1 T0,1,0,-1 T0,0,1,-1 T0,3,2,-1 T0,2,2,-1 T0,2,2,-1 T0,2,2,-1
T0,2,2,-1 T0,2,2,-1 T0,2,2,-1 T0,2,2,-1 T0,4,0,-1 T0,1,0,-1 T0,2,0,-1 T0,1,0,-1 T0,0,1,-1 T0,3,2,-1 T0,2,2,-1 T0,2,2,-1 T0,2,2,-1
T0,2,2,-1 T0,2,2,-1 T0,2,2,-1 T0,2,2,-1 T0,4,0,-1 T0,1,0,-1 T0,2,0,-1 T0,1,0,-1 T0,0,1,-1 T0,3,2,-1 T0,2,2,-1 T0,2,2,-1 T0,2,2,-1
T0,2,2,-1 T0,2,2,-1 T0,2,2,-1 T0,2,2,-1 T0,4,0,-1 T0,1,0,-1 T0,2,0,-1 T0,1,0,-1 T0,0,1,-1 T0,3,2,-1 T0,2,2,-1 T0,2,2,-1 T0,2,2,-1
T0,2,2,-1 T0,2,2,-1 T0,2,2,-1 T0,2,2,-1 T0,4,0,-1 T0,1,0,-1 T0,2,0,-1 T0,1,0,-1 T0,0,1,-1 T0,3,2,-1 T0,2,2,-1 T0,2,2,-1 T0,2,2,-1
T0,0,0,-1 T0,1,1,-1 T0,1,1,-1 T0,1,1,-1 T0,1,0,-1 T0,1,0,-1 T0,2,0,-1 T0,1,0,-1 T0,1,0,-1 T0,1,1,-1 T0,1,1,-1 T0,1,1,-1 T0,3,0,-1
T0,0,0,-1 T0,1,0,-1 T0,1,5,-1 T0,1,0,-1 T0,1,5,-1 T0,1,0,-1 T0,2,0,-1 T0,1,0,-1 T0,0,5,-1 T0,1,0,-1 T0,0,5,-1 T0,1,0,-1 T0,3,0,-1
T0,0,0,-1 T0,1,0,-1 T0,1,0,-1 T0,1,0,-1 T0,1,0,-1 T0,1,0,-1 T0,2,0,-1 T0,1,0,-1 T0,1,0,-1 T0,1,0,-1 T0,1,0,-1 T0,1,0,-1 T0,3,0,-1
T0,0,0,-1 T0,1,0,-1 T0,1,5,-1 T0,1,0,-1 T0,1,5,-1 T0,1,0,-1 T0,2,0,-1 T0,1,0,-1 T0,0,5,-1 T0,1,0,-1 T0,0,5,-1 T0,1,0,-1 T0,3,0,-1
T0,0,0,-1 T0,1,0,-1 T0,1,0,-1 T0,1,0,-1 T0,1,0,-1 T0,1,0,-1 T0,2,0,-1 T0,1,0,-1 T0,1,0,-1 T0,1,0,-1 T0,1,0,-1 T0,1,0,-1 T0,3,0,-1
T0,0,0,-1 T0,1,0,-1 T0,1,5,-1 T0,1,0,-1 T0,1,5,-1 T0,1,0,-1 T0,2,0,-1 T0,1,0,-1 T0,0,5,-1 T0,1,0,-1 T0,0,5,-1 T0,1,0,-1 T0,3,0,-1
T0,0,0,-1 T0,1,0,-1 T0,1,0,-1 T0,2,0,-1 T0,1,0,-1 T0,1,0,-1 T0,2,0,-1 T0,1,0,-1 T0,1,0,-1 T0,2,0,-1 T0,1,0,-1 T0,1,0,-1 T0,3,0,-1
T0,0,0,-1 T0,1,0,-1 T0,1,0,-1 T0,2,0,-1 T0,1,0,-1 T0,1,0,-1 T0,2,0,-1 T0,1,0,-1 T0,1,0,-1 T0,2,0,-1 T0,1,0,-1 T0,1,0,-1 T0,3,0,-1
T0,0,0,-1 T0,1,0,-1 T0,1,0,-1 T0,2,0,-1 T0,1,0,-1 T0,1,0,-1 T0,2,0,-1 T0,1,0,-1 T0,1,0,-1 T0,2,0,-1 T0,1,0,-1 T0,1,0,-1 T0,3,0,-1
T0,0,0,-1 T0,1,0,-1 T0,1,0,-1 T0,2,0,-1 T0,1,0,-1 T0,1,0,-1 T0,2,0,-1 T0,1,0,-1 T0,1,0,-1 T0,2,0,-1 T0,1,0,-1 T0,1,0,-1 T0,3,0,-1
T0,0,0,-1 T0,1,0,-1 T0,1,0,-1 T0,2,0,-1 T0,1,0,-1 T0,1,0,-1 T0,2,0,-1 T0,1,0,-1 T0,1,0,-1 T0,2,0,-1 T0,1,0,-1 T0,1,0,-1 T0,3,0,-1
T0,0,0,-1 T0,1,0,-1 T0,1,0,-1 T0,2,0,-1 T0,1,0,-1 T0,1,0,-1 T0,2,0,-1 T0,1,0,-1 T0,1,0,-1 T0,2,0,-1 T0,1,0,-1 T0,1,0,-1 T0,3,0,-1
T0,0,0,-1 T0,1,0,-1 T0,1,0,-1 T0,2,0,-1 T0,1,0,-1 T0,1,0,-1 T0,2,0,-1 T0,1,0,-1 T0,1,0,-1 T0,2,0,-1 T0,1,0,-1 T0,1,0,-1 T0,3,0,-1
T0,0,0,-1 T0,1,0,-1 T0,1,0,-1 T0,2,0,-1 T0,1,0,-1 T0,1,0,-1 T0,2,0,-1 T0,1,0,-1 T0,1,0,-1 T0,2,0,-1 T0,1,0,-1 T0,1,0,-1 T0,3,0,-1
T0,0,0,-1 T0,1,0,-1 T0,1,0,-1 T0,2,0,-1 T0,1,0,-1 T0,1,0,-1 T0,2,0,-1 T0,1,0,-1 T0,1,0,-1 T0,2,0,-1 T0,1,0,-1 T0,1,0,-1 T0,3,0,-1
T0,0,0,-1 T0,1,0,-1 T0,1,0,-1 T0,2,0,-1 T0,1,0,-1 T0,1,0,-1 T0,2,0,-1 T0,1,0,-1 T0,1,0,-1 T0,2,0,-1 T0,1,0,-1 T0,1,0,-1 T0,3,0,-1
T0,0,0,-1 T0,1,0,-1 T0,1,0,-1 T0,2,0,-1 T0,1,0,-1 T0,1,0,-1 T0,2,0,-1 T0,1,0,-1 T0,1,0,-1 T0,2,0,-1 T0,1,0,-1 T0,1,0,-1 T0,3,0,-1
T0,0,0,-1 T0,1,0,-1 T0,1,0,-1 T0,2,0,-1 T0,1,0,-1 T0,1,0,-1 T0,2,0,-1 T0,1,0,-1 T0,1,0,-1 T0,2,0,-1 T0,1,0,-1 T0,1,0,-1 T0,3,0,-1
T0,0,0,-1 T0,1,0,-1 T0,1,0,-1 T0,2,0,-1 T0,1,0,-1 T0,1,0,-1 T0,2,0,-1 T0,1,0,-1 T0,1,0,-1 T0,2,0,-1 T0,1,0,-1 T0,1,0,-1 T0,3,0,-1
T0,0,0,-1 T0,1,0,-1 T0,1,0,-1 T0,2,0,-1 T0,1,0,-1 T0,1,0,-1 T0,2,0,-1 T0,1,0,-1 T0,1,0,-1 T0,2,0,-1 T0,1,0,-1 T0,1,0,-1 T0,3,0,-1
T0,0,0,-1 T0,1,0,-1 T0,1,0,-1 T0,2,0,-1 T0,1,0,-1 T0,1,0,-1 T0,2,0,-1 T0,1,0,-1 T0,1,0,-1 T0,2,0,-1 T0,1,0,-1 T0,1,0,-1 T0,3,0,-1
T0,0,0,-1 T0,1,0,-1 T0,1,0,-1 T0,2,0,-1 T0,1,0,-1 T0,1,0,-1 T0,2,0,-1 T0,1,0,-1 T0,1,0,-1 T0,2,0,-1 T0,1,0,-1 T0,1,0,-1 T0,3,0,-1
T0,0,0,-1 T0,1,0,-1 T0,1,0,-1 T0,2,0,-1 T0,1,0,-1 T0,1,0,-1 T0,2,0,-1 T0,1,0,-1 T0,1,0,-1 T0,2,0,-1 T0,1,0,-1 T0,1,0,-1 T0,3,0,-1
T0,0,0,-1 T0,1,0,-1 T0,1,0,-1 T0,2,0,-1 T0,1,0,-1 T0,1,0,-1 T0,2,0,-1 T0,1,0,-1 T0,1,0,-1 T0,2,0,-1 T0,1,0,-1 T0,1,0,-1 T0,3,0,-1
T0,0,0,-1 T0,1,0,2 T0,1,0,-1 T0,2,0,-1 T0,1,0,-1 T0,1,0,-1 T0,2,0,-1 T0,1,0,-1 T0,1,0,-1 T0,2,0,-1 T0,1,0,-1 T0,1,0,-1 T0,3,0,-1
T0,0,0,-1 T0,1,0,-1 T0,1,0,-1 T0,2,0,-1 T0,1,0,-1 T0,1,0,-1 T0,2,0,-1 T0,1,0,-1 T0,1,0,-1 T0,2,0,-1 T0,1,0,-1 T0,1,0,-1 T0,3,0,-1
T0,0,0,-1 T0,1,0,-1 T0,1,0,-1 T0,2,0,-1 T0,1,0,-1 T0,1,0,-1 T0,2,0,-1 T0,1,0,-1 T0,1,0,-1 T0,2,0,-1 T0,1,0,-1 T0,1,0,-1 T0,3,0,-1
T0,0,0,-1 T0,1,0,-1 T0,1,0,-1 T0,2,0,-1 T0,1,0,-1 T0,1,0,-1 T0,2,0,-1 T0,1,0,-1 T0,1,0,-1 T0,2,0,-1 T0,1,0,-1 T0,1,0,-1 T0,3,0,-1
T0,0,0,-1 T0,1,0,-1 T0,1,0,-1 T0,2,0,-1 T0,1,0,-1 T0,1,0,-1 T0,2,0,-1 T0,1,0,-1 T0,1,0,-1 T0,2,0,-1 T0,1,0,-1 T0,1,0,-1 T0,3,0,-1
T0,0,0,-1 T0,1,0,-1 T0,1,0,-1 T0,2,0,-1 T0,1,0,-1 T0,1,0,-1 T0,2,0,-1 T0,1,0,-1 T0,1,0,-1 T0,2,0,-1 T0,1,0,-1 T0,1,0,-1 T0,3,0,-1
T0,0,0,-1 T0,1,0,-1 T0,1,0,-1 T0,2,0,-1 T0,1,0,-1 T0,1,0,-1 T0,2,0,-1 T0,1,0,-1 T0,1,0,-1 T0,2,0,-1 T0,1,0,-1 T0,1,0,-1 T0,3,0,-1
T0,0,0,-1 T0,1,0,-1 T0,1,0,-1 T0,2,0,-1 T0,1,0,-1 T0,1,0,-1 T0,2,0,-1 T0,1,0,-1 T0,1,0,-1 T0,2,0,-1 T0,1,0,-1 T0,1,0,-1 T0,3,0,-1
T0,0,0,-1 T0,1,0,-1 T0,1,0,-1 T0,2,0,-1 T0,1,0,-1 T0,1,0,-1 T0,2,0,-1 T0,1,0,-1 T0,1,0,-1 T0,2,0,-1 T0,1,0,-1 T0,1,0,-1 T0,3,0,-1
T0,0,0,-1 T0,1,0,-1 T0,1,0,-1 T0,2,0,-1 T0,1,0,-1 T0,1,0,-1 T0,2,0,-1 T0,1,0,-1 T0,1,0,-1 T0,2,0,-1 T0,1,0,-1 T0,1,0,-1 T0,3,0,-1
T0,0,0,-1 T0,1,0,-1 T0,1,0,-1 T0,2,0,-1 T0,1,0,-1 T0,1,0,-1 T0,2,0,-1 T0,1,0,-1 T0,1,0,-1 T0,2,0,-1 T0,1,0,-1 T0,1,0,-1 T0,3,0,-1
T0,0,0,-1 T0,1,0,-1 T0,1,0,-1 T0,2,0,-1 T0,1,0,-1 T0,1,0,-1 T0,2,0,-1 T0,1,0,-1 T0,1,0,-1 T0,2,0,-1 T0,1,0,-1 T0,1,0,-1 T0,3,0,-1
T0,0,0,-1 T0,1,0,-1 T0,1,0,-1 T0,2,0,-1 T0,1,0,-1 T0,1,0,-1 T0,2,0,-1 T0,1,0,-1 T0,1,0,-1 T0,2,0,-1 T0,1,0,-1 T0,1,0,-1 T0,3,0,-1
T0,0,0,-1 T0,1,0,-1 T0,1,0,-1 T0,2,0,-1 T0,1,0,-1 T0,1,0,-1 T0,2,0,-1 T0,1,0,-1 T0,1,0,-1 T0,2,0,-1 T0,1,0,-1 T0,1,0,-1 T0,3,0,-1
T0,0,0,-1 T0,1,0,-1 T0,1,0,-1 T0,2,0,-1 T0,1,0,-1 T0,1,0,-1 T0,2,0,-1 T0,1,0,-1 T0,1,0,-1 T0,2,0,-1 T0,1,0,-1 T0,1,0,-1 T0,3,0,-1
